14 14 14 14 14 14 15 32 15 15 15 15 19 00 00 06 00 00 00 00 00 00 00 00
14 14 14 14 14 14 15 32 15 38 33 33 27 07 07 09 07 07 07 07 07 13 00 00
14 14 14 14 14 14 15 32 15 32 15 15 19 00 00 06 00 00 00 00 00 06 00 00
33 33 33 29 33 33 33 34 33 37 14 14 19 00 00 10 13 00 00 00 00 06 00 00
14 14 14 32 14 14 14 32 14 14 14 14 19 00 00 00 06 00 00 00 00 06 00 00
14 14 14 32 14 14 14 32 14 14 14 14 19 00 00 00 06 00 00 00 00 06 00 00
14 14 14 32 14 14 14 32 14 14 14 14 19 00 00 00 06 00 00 00 00 06 00 00
14 14 14 32 14 14 14 36 33 33 29 33 26 07 07 07 09 07 07 13 00 06 00 00
33 33 33 28 14 14 14 14 14 14 32 14 19 00 00 00 06 00 00 06 00 06 00 00
14 14 14 32 14 14 14 14 14 14 32 14 19 00 00 00 06 00 00 06 00 06 00 00
14 14 14 36 33 33 33 33 33 33 35 33 27 07 07 07 09 07 07 04 07 08 07 07
14 14 14 14 14 14 14 14 14 14 32 14 19 00 00 00 06 00 00 00 00 06 00 00
14 14 14 14 14 14 14 14 14 14 32 14 19 00 00 00 06 00 00 00 00 06 00 00
14 14 14 14 14 14 14 14 14 14 32 14 19 00 00 00 06 00 00 00 00 06 00 00