0 0 0 0 0 0 5 32 5 5 5 5 39 1 1 10 1 1 1 1 1 1 1 1 
0 0 0 0 0 0 5 32 5 19 31 31 30 13 13 22 13 13 13 13 13 12 1 1 
0 0 0 0 0 0 5 32 5 32 5 5 39 1 1 10 1 1 1 1 1 10 1 1 
31 31 31 3 31 31 31 25 31 28 0 0 39 1 1 18 12 1 1 1 1 10 1 1 
0 0 0 32 0 0 0 32 0 0 0 0 39 1 1 1 10 1 1 1 1 10 1 1 
0 0 0 32 0 0 0 32 0 0 0 0 39 1 1 1 10 1 1 1 1 10 1 1 
0 0 0 32 0 0 0 32 0 0 0 0 39 1 1 1 10 1 1 1 1 10 1 1 
0 0 0 32 0 0 0 27 31 31 3 31 33 13 13 13 22 13 13 12 1 10 1 1 
31 31 31 2 0 0 0 0 0 0 32 0 39 1 1 1 10 1 1 10 1 10 1 1 
0 0 0 32 0 0 0 0 0 0 32 0 39 1 1 1 10 1 1 10 1 10 1 1 
0 0 0 27 31 31 31 31 31 31 20 31 30 13 13 13 22 13 13 17 13 23 13 13 
0 0 0 0 0 0 0 0 0 0 32 0 39 1 1 1 10 1 1 1 1 10 1 1 
0 0 0 0 0 0 0 0 0 0 32 0 39 1 1 1 10 1 1 1 1 10 1 1 
0 0 0 0 0 0 0 0 0 0 32 0 39 1 1 1 10 1 1 1 1 10 1 1 
