14 14 14 14 14 14 15 32 15 15 15 15 19 0 0 6 0 0 0 0 0 0 0 0 
14 14 14 14 14 14 15 32 15 38 33 33 27 7 7 9 7 7 7 7 7 13 0 0 
14 14 14 14 14 14 15 32 15 32 15 15 19 0 0 6 0 0 0 0 0 6 0 0 
33 33 33 29 33 33 33 34 33 37 14 14 19 0 0 10 13 0 0 0 0 6 0 0 
14 14 14 32 14 14 14 32 14 14 14 14 19 0 0 0 6 0 0 0 0 6 0 0 
14 14 14 32 14 14 14 32 14 14 14 14 19 0 0 0 6 0 0 0 0 6 0 0 
14 14 14 32 14 14 14 32 14 14 14 14 19 0 0 0 6 0 0 0 0 6 0 0 
14 14 14 32 14 14 14 36 33 33 29 33 26 7 7 7 9 7 7 13 0 6 0 0 
33 33 33 28 14 14 14 14 14 14 32 14 19 0 0 0 6 0 0 6 0 6 0 0 
14 14 14 32 14 14 14 14 14 14 32 14 19 0 0 0 6 0 0 6 0 6 0 0 
14 14 14 36 33 33 33 33 33 33 35 33 27 7 7 7 9 7 7 4 7 8 7 7 
14 14 14 14 14 14 14 14 14 14 32 14 19 0 0 0 6 0 0 0 0 6 0 0 
14 14 14 14 14 14 14 14 14 14 32 14 19 0 0 0 6 0 0 0 0 6 0 0 
14 14 14 14 14 14 14 14 14 14 32 14 19 0 0 0 6 0 0 0 0 6 0 0 
